v12 + + 

255 255 255 255
45 124 249 255

111202100
010202100
010222100
010020111
>
000101000
000101000
000111000
000010000
>
111000000
010000000
010000000
010000000
>
000000100
000000100
000000100
000000111
>