mh b21 - d + d +

255 255 255 255
112 125 93 255

022000110
220112011
000000000
110211011
011000110
>
022000000
000010000
000000000
000010000
011000110
>
000000000
220002000
000000000
110210011
000000000
>