v21 v01 - b10 - mh d +

67 243 125 255
9 121 68 255

00011000
00011000
00011000
02000020
22022022
20022002
>
00000000
00000000
00000000
02000020
22000022
20000002
>
00011000
00011000
00011000
02000010
22000011
20000001
>
00000000
11000011
11000011
11000021
11022022
10022002
>
